111111
1P00C1
11C011
1C01E1
111111