111111
1P00C1
11C001
1C10E1
111111